R 500 500

NO ./texture/north.xpm
SO ./texture/south.xpm
EA ./texture/east.xpm
WE ./texture/west.xpm
S ./texture/sprite.xpm
F 128,128,128 
C 128,0,0

1111111
101021
12N001
100111
11111








